%-%%%%
%----%
%----%
%----%
%----%
%-%%%%
%-%%%%
%----%
%----%
%----%
%----%
%%%%%%
