%%%%%%%%%%%%%%%%%%%%%%%%%%%%%%%%%%%%%%%%
%---------------------------%%%%%%%%---%
%----%%%%%%%-----------------------%---%
%----%%--------%%%%%%-%%-----%%----%---%
%---------%----------------------------%
%%%%%%%%%%%%%%%%%%-%%%%%%%%%%%%%%%%%---%
%--------------------------------------%
%---%%%%%%%%%%%%%%%%%%%%%%%%%%%%%%%%%%%%
%---%%-------%%%%%-%%%%%%%%%%%%%%%%%---%
%-------%%%----------------------------%
%%%%%%%%%%%%%%%%%%%---%%%%%%%%%%%%%%%%%%
%%%%%----------------------%%%%%%%%%%%%%
%%%%%%%%%%%%%%%%%%%%%%%%%%%%%%%%%%%%%%%%
