%%%%%%%%%%%%%%%%%%%%%%%%%%%%%%%%%%%%%%%%
%---------------------------%%%%%%%%---%
%----%%%%%%%-----------------------%---%
%----%%---%----%%%%%%-%%-----%%----%---%
%---------%----------------------------%
%---------%----------------------------%
%---------%----------------------------%
%---------%------------%%%%%%----------%
%---------%------------%%%%%%----------%
%---------%------------%%%%%%----------%
%---------%----------------------------%
%---------%----------------------------%
%---------%----------------------------%
%---------%----------------------------%
%%%%%%%%%%%%%%%%%%-%%%%%%%%%%%%%%%%%---%
%--------------------------------------%
%--------------------------------------%
%--------------------------------------%
%--------------------------------------%
%--------------------------%%%%%%%%%%%%%
%--------------------------------------%
%--------------------------------------%
%---%%%%%%%%%%%%%%%%%%%%%%%%%%%%%%%%%%%%
%---%%-------%%%%%-%%%%%%%%%%%%%%%%%---%
%-------%%%----------------------------%
%%%%%%%%%%%%%%%%%%%---%%%%%%%%%%%%%%%%%%
%%%%%----------------------%%%%%%%%%%%%%
%%%%%----------------------%%%%%%%%%%%%%
%%%%%----------------------%%%%%%%%%%%%%
%%%%%----------------------%%%%%%%%%%%%%
%%%%%----------------------%%%%%%%%%%%%%
%%%%%----------------------%%%%%%%%%%%%%
%%%%%----------------------%%%%%%%%%%%%%
%%%%%%%%%%%%%%%%%%%%%%%%%%%%%%%%%%%%%%%%
