%%%%%%%%%%%%%%%%%%%%%%%%%%%%%%%%%%%%%%%%
%-------------------------------%------%
%-------------------------------%------%
%-------------------------------%------%
%-------------------------------%------%
%-------------------------------%------%
%--------------------------------------%
%--------------------------------------%
%--------------------------------------%
%--------------------------------------%
%--------------------------------------%
%----------------------%%%%%%%%%%%%%%%%%
%--------------------------------------%
%--------------------------------------%
%--------------------------------------%
%--------------------------------------%
%%%%%%%--------------------------------%
%--------------------------------------%
%--------------------------------------%
%--------------------------------------%
%--------------------------------------%
%%%%%%%%%%%%%%%%%%%%%%%%%%%%%%%%%%%%%%%%
